0 0 0 0 0 3 3 3 3 3 3 3 3 3 3 3 3 3 3 3 3 3 3 3 3 3 3 3 3 3 3 3 3 3 3 3 3 3 3 3 3 3 3 3 3 3 3 3 3 3 3 3 3 3 3 3 3 3 3 3 3 3 3 3 3 3 3 3 3 3 0 0 0 3 3 3 3 3 3 3 3 3 3 3 3 3 3 3 3 0 0 0 0 0 0 3 3 3 3 3 3 3 3 3 3 3 3 3 3 0 0 0 0 0 0 0 0 0 0 0 0 0 0 0 0 0 0 0 0 0 0 0 0 0 0 0 0 0 0 0 0 0 0 0 0 0 0 0 0 0 0 0 0 0 0 0 0 0 0 0 0 0 0 0 0 0 0 0 0 0 0 0 0 0 0 0 0 0 0 0 0 0 0 0 0 0 0 0 0 0 0 0 0 0 0 0 0 0 0 0 0 0 0 0 0 0 0 0 0 0 0 0 0 0 0 0 0 0 0 0 0 0 0 0 0 0 0 0 0 0 0 0 0 0 0 0 0 0 0 0 0 0 0 0 0 0 0 0 0 0 0 0 0 0 0 0 0 0 0 0 0 0 0 0 0 0 0 0 0 0 0 0 0 0 0 0 0 0 0 0 0 0 0 0 0 0 0 0 0 0 0 0 0 0 0 0 0 0 0 0 0 0 0 0 0 0 0 0 0 0 0 0 0 0 0 0 0 0 0 0 0 0 0 0 0 0 0 0 0 0 0 0 0 0 0 0 0 0 0 0 0 0 0 0 0 0 0 0 0 0 0 0 0 0 0 0 0 0 0 0 0 0 0 0 0 0 0 0 0 0 0 0 0 0 0 0 0 0 0 0 0 0 0 0 0 0 0 0 0 0 0 0 0 0 0 0 0 0 0 0 0 0 0 0 0 
1 0 0 0 2 8 8 8 8 8 8 8 8 8 8 8 8 8 8 8 8 8 8 8 8 8 3 3 3 3 3 3 3 3 3 3 3 3 3 3 3 3 3 3 3 8 3 3 3 3 3 3 3 3 3 3 3 3 3 3 3 3 3 3 3 8 3 3 3 0 0 0 0 0 3 3 3 3 3 3 3 3 3 3 3 8 3 3 3 0 0 0 0 0 0 0 3 3 3 3 3 3 3 3 3 8 3 3 3 0 0 0 0 0 0 0 3 3 3 3 3 3 3 3 3 8 3 3 3 0 0 0 0 0 0 0 3 3 3 3 3 3 3 3 3 8 3 3 3 0 0 0 0 0 0 0 0 0 3 3 3 3 3 3 3 8 3 3 3 0 0 0 0 0 0 0 0 0 3 3 3 3 3 3 3 8 3 3 3 3 3 3 0 0 0 0 0 0 0 0 3 3 3 3 3 8 3 3 3 3 3 3 0 0 0 0 0 0 0 0 0 0 0 0 0 8 3 3 3 3 3 3 3 3 0 0 0 0 0 0 0 0 0 0 0 8 3 3 3 3 3 3 3 3 0 0 0 0 0 0 0 0 0 0 0 8 3 3 3 3 3 3 3 3 0 0 0 0 0 0 0 0 0 0 0 8 3 3 3 3 3 3 3 3 3 3 3 3 3 3 3 3 3 3 3 8 3 2 2 2 3 3 3 2 2 2 3 3 3 2 2 2 2 3 3 8 3 3 2 3 3 3 3 3 2 3 3 3 3 3 3 3 2 3 3 8 3 3 2 3 3 3 3 3 2 3 3 3 3 2 2 2 2 3 3 8 3 3 2 3 3 3 3 3 2 3 3 3 3 3 3 3 2 3 3 8 3 2 2 3 3 3 3 2 2 3 3 3 3 2 2 2 2 3 3 
2 0 0 1 3 8 8 8 8 8 8 8 8 8 8 8 8 8 8 8 8 8 8 8 8 8 3 3 3 3 3 3 3 3 3 3 3 3 3 3 3 3 3 3 3 8 3 3 3 3 3 3 3 3 3 3 3 3 3 3 3 3 3 3 3 8 3 3 3 3 3 3 3 3 3 3 3 3 3 3 3 3 3 3 3 8 3 3 3 3 3 3 3 3 3 3 3 3 3 3 3 3 3 3 3 8 3 3 3 3 3 3 3 3 3 3 3 3 3 3 3 3 3 3 3 8 3 3 3 3 3 0 0 0 0 0 0 0 0 0 0 0 0 0 0 8 3 3 3 3 3 0 0 0 0 0 0 0 0 0 0 0 0 0 0 8 3 3 3 0 0 0 0 0 10 0 0 0 0 0 0 0 0 0 0 8 3 3 3 0 0 0 0 0 0 0 0 0 0 0 0 0 0 0 0 0 0 0 0 0 0 0 0 0 0 0 0 0 0 0 0 0 0 0 0 0 0 0 0 0 0 0 0 0 0 0 0 0 0 3 3 3 3 3 3 0 0 0 0 0 0 0 0 3 3 3 3 3 3 3 3 3 3 3 3 0 0 0 3 3 3 3 3 3 3 3 3 3 3 3 3 3 3 3 3 8 3 3 3 3 3 3 3 3 3 3 3 3 3 3 3 3 3 3 3 8 3 3 3 3 3 3 3 3 3 3 3 3 3 3 3 3 3 3 3 8 3 3 3 3 3 3 3 3 3 3 3 3 3 3 3 3 3 3 3 8 3 3 3 3 3 3 3 3 3 3 3 3 3 3 3 3 3 3 3 8 3 3 3 3 3 3 3 3 3 3 3 3 3 3 3 3 3 3 3 8 8 8 8 8 8 8 8 8 8 8 8 8 8 8 8 8 8 8 8 
3 8 4 2 0 3 3 3 3 3 3 3 3 3 3 3 3 0 0 0 0 0 0 3 3 3 3 3 3 3 3 3 3 3 3 3 3 0 0 0 0 0 0 3 3 3 3 3 3 3 3 3 0 0 0 0 0 0 0 0 0 0 3 3 3 3 3 3 3 3 0 0 0 0 0 0 0 0 0 0 0 0 3 3 3 3 3 3 0 0 0 0 0 0 0 0 0 0 0 0 0 0 3 3 3 3 0 0 0 0 0 0 0 0 0 0 0 0 0 0 0 0 3 3 3 0 0 0 0 0 0 0 0 0 0 0 0 0 0 0 0 0 3 3 3 0 0 0 0 0 0 0 0 0 0 0 0 0 0 0 0 0 3 3 3 0 0 0 0 0 0 0 0 0 0 0 0 0 0 0 0 3 3 3 3 0 0 0 0 0 0 0 0 0 0 0 0 0 0 0 0 3 3 3 3 0 0 0 0 0 0 0 0 0 0 0 0 0 0 0 0 3 3 3 3 3 3 3 3 3 3 3 3 0 0 0 0 0 0 0 3 3 3 3 3 3 3 3 3 3 3 3 3 0 0 0 0 0 0 0 3 3 3 3 3 3 3 3 3 3 3 3 3 0 0 0 0 0 0 0 3 3 3 3 3 3 3 3 3 3 3 3 3 0 0 0 0 0 0 0 3 3 3 3 3 3 3 3 3 3 3 3 0 0 0 0 0 0 0 3 3 3 3 3 3 3 3 3 3 3 3 3 0 0 0 0 0 0 0 3 3 3 3 3 3 3 3 3 3 3 3 3 0 0 0 0 0 0 0 3 3 3 3 3 3 3 3 3 3 3 3 3 0 0 0 0 0 0 0 3 3 3 3 3 3 3 3 3 3 3 3 3 0 0 0 0 0 0 0 3 3 3 3 3 3 
8 0 3 0 0 3 3 3 3 3 3 3 3 3 3 3 3 3 3 3 3 3 3 3 3 3 3 3 3 3 3 3 3 3 3 3 3 3 3 3 3 3 3 3 3 3 3 3 3 3 0 0 0 0 0 0 0 0 0 0 3 3 3 3 3 3 3 3 3 3 0 0 0 0 0 0 0 0 0 0 3 3 3 3 3 3 3 3 3 3 0 0 0 0 0 0 0 0 0 0 3 3 3 3 3 3 3 3 0 0 0 0 0 0 0 0 0 0 0 0 0 0 3 3 3 3 3 3 0 0 9 0 0 0 0 0 0 0 0 0 0 0 3 3 3 3 3 3 0 0 0 0 0 0 0 0 0 0 0 0 0 0 3 3 3 3 3 3 0 0 0 0 0 0 0 0 0 0 0 0 0 0 3 3 3 3 3 3 0 0 0 0 0 0 0 0 0 0 0 0 0 0 3 3 3 3 3 3 3 3 0 0 0 0 0 0 0 0 0 0 0 3 3 3 3 3 3 3 3 3 0 0 0 0 0 0 0 0 0 0 0 3 3 3 3 3 3 3 3 3 0 0 0 0 0 0 0 0 0 0 0 3 3 3 3 3 3 3 3 3 3 0 0 0 0 0 0 0 0 0 0 3 3 3 3 3 3 3 3 3 3 0 0 0 0 0 0 0 0 0 0 3 3 3 3 3 3 3 3 3 3 0 0 0 0 0 0 0 0 0 0 3 3 3 3 3 3 3 3 3 3 0 0 0 0 0 0 0 0 0 0 3 3 3 3 3 3 3 3 3 3 3 0 0 0 0 0 0 0 0 0 3 3 3 3 3 3 3 3 3 3 3 0 0 0 0 0 0 0 0 0 0 0 3 3 3 3 3 3 3 3 3 3 3 3 3 3 0 0 0 0 0 0 3 3
4 3 0 5 0 3 3 3 3 3 3 3 0 0 0 0 0 0 0 3 3 3 3 3 3 3 3 3 3 3 3 3 0 0 0 0 0 0 0 3 3 3 3 3 3 3 3 3 0 0 0 0 0 0 0 0 0 0 0 3 3 3 3 3 3 3 3 3 0 0 0 0 0 0 0 0 0 0 0 3 3 3 3 3 3 3 3 3 0 0 0 0 0 0 0 0 0 0 0 3 3 3 3 3 3 0 0 0 0 0 0 0 0 0 0 0 0 0 0 3 3 3 3 3 3 0 0 0 0 0 0 0 0 0 0 0 0 0 0 3 3 3 3 3 3 0 0 0 0 0 0 0 0 0 0 0 0 0 3 3 3 3 3 3 3 0 0 0 0 0 0 0 0 0 0 0 0 0 3 3 3 3 3 3 3 0 0 0 0 0 0 0 0 0 0 0 0 0 3 3 3 3 3 3 3 0 0 0 0 0 0 0 0 0 0 0 0 0 3 3 3 3 3 3 3 0 0 0 0 0 0 0 0 0 0 0 0 0 3 3 3 3 3 3 3 0 0 0 0 0 0 0 0 0 0 0 0 3 3 3 3 3 3 3 3 0 0 0 0 0 0 0 0 0 0 0 0 3 3 3 3 3 3 3 3 0 0 0 0 0 0 0 0 0 0 0 0 3 3 3 3 3 3 3 3 0 0 0 0 0 0 0 0 0 0 0 0 3 3 3 3 3 3 3 3 0 0 0 0 0 0 0 0 0 0 0 0 3 3 3 3 3 3 3 3 0 0 0 0 0 0 0 0 0 0 0 0 3 3 3 3 3 3 3 3 6 6 6 6 6 6 6 6 6 6 6 6 6 3 3 3 3 3 3 3 6 6 6 6 6 6 6 6 6 6 6 6 6 3 3 3 3 3 3 3 
5 0 6 0 4 3 3 3 3 3 3 3 3 3 3 3 3 3 3 3 3 3 3 3 3 3 3 3 3 3 3 3 3 3 3 3 3 3 3 3 3 3 3 3 3 3 3 3 3 3 3 3 3 3 3 3 3 3 3 3 3 3 3 3 3 3 3 3 3 3 3 3 3 3 3 3 3 3 3 3 3 3 3 3 3 3 3 3 3 3 3 3 3 3 3 3 3 3 3 3 3 3 3 3 3 3 3 3 3 3 3 3 3 3 3 3 3 3 3 3 3 3 0 0 0 3 3 3 3 3 3 3 3 3 3 3 0 0 0 0 0 0 0 0 0 3 3 3 3 3 3 3 3 3 3 3 0 0 0 0 0 0 0 0 0 3 3 3 3 3 3 3 3 3 3 3 0 0 0 0 0 0 0 0 0 3 3 3 3 0 0 0 0 0 0 0 0 0 0 0 0 0 0 0 0 3 3 3 3 0 0 0 0 0 0 0 0 0 0 0 0 0 0 0 0 3 3 3 3 0 0 0 0 0 0 0 0 0 0 0 0 0 0 0 0 3 3 3 3 0 0 0 0 0 0 0 0 0 0 0 0 0 0 0 0 3 3 3 3 0 0 0 0 0 0 0 0 0 0 0 0 0 0 0 0 3 3 3 0 0 0 0 0 0 0 0 0 0 0 0 0 0 0 0 0 3 3 3 0 0 0 0 0 0 0 0 0 0 0 0 0 0 0 0 0 3 3 0 0 0 0 0 0 0 0 0 0 0 0 0 0 0 0 0 0 3 3 0 0 0 0 0 0 0 0 0 0 0 0 0 0 0 0 0 0 3 0 0 0 0 0 0 0 0 0 0 0 0 0 0 0 0 0 0 0 3 0 0 0 0 0 0 0 0 0 0 0 0 0 0 0 0 0 0 0 
6 5 0 9 0 3 0 0 0 0 0 0 0 0 0 0 0 0 0 0 0 0 0 0 11 3 3 0 0 0 0 0 0 0 0 0 0 0 0 0 0 0 0 0 11 3 3 3 0 0 0 0 0 0 0 0 0 0 0 0 0 0 0 0 11 3 3 3 0 0 0 0 0 0 0 0 0 0 0 0 0 0 0 0 11 3 3 3 3 0 0 0 0 0 0 0 0 0 0 0 0 0 0 0 11 3 3 3 0 0 0 0 0 0 0 0 0 0 0 0 0 0 0 0 11 3 3 3 0 0 0 0 0 0 0 0 0 0 0 0 0 0 0 0 11 3 3 0 0 0 0 0 0 0 0 0 0 0 0 0 0 0 0 0 11 3 0 0 0 0 0 0 0 0 0 0 0 0 0 0 0 0 0 0 11 3 0 0 0 0 0 0 0 0 0 0 0 0 0 0 0 0 0 0 11 0 0 0 0 0 0 0 0 0 0 0 0 0 0 0 0 0 0 0 11 3 0 0 0 0 0 0 0 0 0 0 0 0 0 0 0 0 0 0 11 3 3 0 0 0 0 0 0 0 0 0 0 0 0 0 0 0 0 0 11 3 3 3 0 0 0 0 0 0 0 0 0 0 0 0 0 0 0 0 11 3 3 3 0 0 0 0 0 0 0 0 0 0 0 0 0 0 0 0 11 3 3 3 0 0 0 0 0 0 0 0 0 0 0 0 0 0 0 0 11 3 3 3 0 0 0 0 0 0 0 0 0 0 0 0 0 0 0 0 11 3 3 3 3 3 3 3 3 3 3 3 0 0 0 0 0 0 0 0 11 3 3 3 3 3 3 3 3 3 3 3 3 3 3 3 0 0 0 0 11 3 3 3 3 3 3 3 3 3 3 3 3 3 3 3 3 3 3 3 3 
9 0 10 0 6 2 2 2 2 2 2 2 2 2 2 2 2 2 2 2 2 2 2 2 2 2 2 2 2 2 2 2 2 2 2 2 2 2 2 2 2 2 2 2 2 2 2 3 3 3 3 3 3 3 7 3 3 3 3 3 3 3 3 3 3 2 2 3 3 3 3 3 3 3 0 3 3 3 3 3 3 3 3 3 3 2 2 3 3 3 3 3 3 3 0 3 3 3 3 3 3 3 3 3 3 2 2 3 3 3 3 3 3 3 0 3 3 3 3 3 3 3 3 3 3 2 2 3 3 3 3 3 3 3 0 3 3 3 3 3 3 3 3 3 3 2 2 3 3 3 3 3 3 3 0 3 3 3 3 3 3 3 3 3 3 2 2 3 3 3 3 3 3 3 0 3 3 3 3 3 3 3 3 3 3 2 2 3 3 3 3 3 3 3 0 3 3 3 3 3 3 3 3 3 3 2 2 0 0 0 0 0 0 0 0 0 0 0 0 0 0 0 0 0 0 2 2 3 3 3 3 3 3 3 0 3 3 3 3 3 3 3 3 3 3 2 2 3 3 3 3 3 3 3 0 3 3 3 3 3 3 3 3 3 3 2 2 3 3 3 3 3 3 3 0 3 3 3 3 3 3 3 3 3 3 2 2 3 3 3 3 3 3 3 0 3 3 3 3 3 3 3 3 3 3 2 2 3 3 3 3 3 3 3 0 3 3 3 3 3 3 3 3 3 3 2 2 3 3 3 3 3 3 3 0 3 3 3 3 3 3 3 3 3 3 2 2 3 3 3 3 3 3 3 0 3 3 3 3 3 3 3 3 3 3 2 2 3 3 3 3 3 3 3 0 3 3 3 3 3 3 3 3 3 3 2 2 3 3 3 3 3 3 3 0 3 3 3 3 3 3 3 3 3 3 
10 9 0 0 12 4 4 3 3 3 3 3 3 3 0 3 3 3 3 3 3 3 3 3 3 4 4 3 3 3 3 3 3 3 0 3 3 3 3 3 3 3 3 3 3 4 4 3 3 3 3 3 3 3 0 3 3 3 3 3 3 3 3 3 3 4 4 3 3 3 3 3 3 3 0 3 3 3 3 3 3 3 3 3 3 4 4 3 3 3 3 3 3 3 0 3 3 3 3 3 3 3 3 3 3 4 4 3 3 3 3 3 3 3 0 3 3 3 3 3 3 3 3 3 3 4 4 3 3 3 3 3 3 3 0 3 3 3 3 3 3 3 3 3 3 4 4 3 3 3 3 3 3 3 0 3 3 0 0 0 0 3 3 3 3 4 4 3 3 3 3 3 3 3 0 3 0 0 3 3 0 0 3 3 3 4 4 3 3 3 3 3 3 3 0 3 0 3 3 3 3 0 3 3 3 4 4 0 0 0 0 0 0 0 0 0 0 3 3 3 3 0 0 0 0 4 4 3 3 3 3 3 3 3 0 3 0 3 3 3 3 0 3 3 3 4 4 3 3 3 3 3 3 3 0 3 0 0 3 3 0 0 3 3 3 4 4 3 3 3 3 3 3 3 0 3 3 0 0 0 0 3 3 3 3 4 4 3 3 3 3 3 3 3 0 3 3 3 3 3 3 3 3 3 3 4 4 3 3 3 3 3 3 3 0 3 3 3 3 3 3 3 3 3 3 4 4 3 3 3 3 3 3 3 0 3 3 3 3 3 3 3 3 3 3 4 4 3 3 3 3 3 3 3 0 3 3 3 3 3 3 3 3 3 3 4 4 2 2 2 2 2 2 2 2 2 2 2 2 2 2 2 2 2 2 4 4 2 2 2 2 2 2 2 2 2 2 2 2 2 2 2 2 2 2  
11 6 0 12 0 3 3 3 3 3 3 3 3 3 3 3 8 4 4 4 4 4 4 4 4 3 3 3 3 3 3 3 3 3 3 3 8 4 4 4 4 4 4 4 4 3 3 3 3 3 3 3 3 3 3 3 8 4 4 4 4 4 4 4 4 3 3 0 0 3 3 3 3 8 8 8 8 4 4 4 4 4 4 4 4 3 3 0 0 0 0 0 0 8 4 4 4 4 4 4 4 4 4 4 4 3 3 0 0 0 0 0 0 8 4 4 4 4 4 4 4 4 4 4 4 3 3 0 0 0 0 0 0 8 4 4 4 4 4 4 4 4 4 4 4 3 3 0 0 0 0 0 0 8 4 4 4 4 4 4 4 4 4 4 4 3 3 0 0 0 0 0 0 8 4 4 4 4 4 4 4 4 4 4 4 3 3 0 0 0 0 0 0 8 4 4 4 4 4 4 4 4 4 4 4 0 0 0 0 0 0 0 0 8 4 4 4 4 4 4 4 4 4 4 4 3 3 0 0 0 0 0 0 8 4 4 4 4 4 4 4 4 4 4 4 3 3 0 0 0 0 0 0 8 4 4 4 4 4 4 4 4 4 4 4 3 3 0 0 0 0 0 0 8 4 4 4 4 4 4 4 4 4 4 4 3 3 0 0 0 0 0 0 8 4 4 4 4 4 4 4 4 4 4 4 3 3 0 0 0 0 0 0 5 4 4 4 4 4 4 4 4 4 4 4 3 3 0 0 0 0 0 0 5 4 4 4 4 4 4 4 4 4 4 4 8 8 8 8 8 8 8 8 8 4 4 4 4 4 4 4 4 4 4 4 4 4 4 4 4 4 4 4 4 4 4 4 4 4 4 4 4 4 4 4 4 4 4 4 4 4 4 4 4 4 4 4 4 4 4 4 4 4 4 4 
12 0 0 10 11 1 1 1 1 1 1 1 1 1 1 1 1 1 1 1 1 1 1 1 1 1 0 1 0 0 0 0 0 0 0 0 0 0 0 0 0 0 0 0 1 1 0 1 0 1 1 1 1 0 1 1 1 1 1 1 1 1 1 0 1 1 0 0 0 1 0 0 1 0 1 0 0 0 0 0 0 0 1 0 1 1 0 1 1 1 0 0 1 0 1 0 1 1 1 1 1 0 1 0 1 1 0 1 0 0 0 0 1 0 1 0 1 0 0 0 0 0 1 0 1 1 0 0 0 1 1 0 1 0 0 0 1 1 1 0 1 1 1 0 1 1 1 1 0 1 0 0 1 1 1 1 1 0 0 0 0 0 1 0 1 1 0 1 0 1 0 0 0 0 0 0 1 0 0 0 1 1 1 0 1 1 0 1 0 1 0 1 1 1 1 0 1 0 1 0 1 0 1 0 1 1 0 1 0 0 0 0 0 0 1 0 1 0 1 0 1 0 1 0 0 1 0 1 0 1 0 0 0 0 1 0 1 0 1 0 0 0 1 0 1 1 0 1 0 1 1 1 1 1 1 0 1 0 1 1 1 1 1 0 1 1 0 0 0 0 0 0 0 0 0 0 1 0 1 0 0 0 0 0 1 1 0 1 1 1 0 1 1 1 1 0 1 0 1 1 1 0 0 0 1 1 0 1 0 0 0 1 0 0 0 0 1 0 1 0 1 0 1 0 1 1 0 1 0 0 0 1 0 1 0 0 1 0 1 0 1 0 1 0 1 1 0 1 1 1 0 1 0 1 1 1 1 0 1 0 1 0 1 0 1 1 0 0 0 0 0 0 0 0 0 0 0 0 1 0 0 0 0 0 1 1 1 1 1 1 1 1 1 1 1 1 1 1 1 1 1 1 1 1 1